backgrounds/temple.png
 . . . . . . . . . . . . . . . . . . . .-. . . . .-. . . . .-. . .-. . . . .-. . . . .-. . . . . . . . . . . . . . . . . . . . 
 . . . . . . . . . . . . . . . . . . . .-. . . . .-. . . . .-. . .-. . . . .-. . . . .-. . . . . . . . . . . . . . . . . . . . 
 . . . . . . . . . . . . . . . . . . . .-. . . . .-. . . . .-. . .-. . . . .-. . . . .-. . . . . . . . . . . . . . . . . . . . 
 . . . . . . . . . . . . . . . . . . . .-. . . . .-. . . . .-. . .-. . . . .-. . . . .-. . . . . . . . . . . . . . . . . . . . 
 . . . . . . . . . . . . . . . . . . . .-. . . . .-. . . . .-. . .-. . . . .-. . . . .-. . . . . . . . . . . . . . . . . . . . 
 . . . . . . . . . . . . . . . . . . . .-. . . . .-. . . . .-. . .-. . . . .-. . . . .-. . . . . . . . . . . . . . . . . . . . 
 . . . . . . . . . . . . . . . . . . . .-. . . . .-. . . . .-. . .-. . . . .-. . . . .-. . . . . . . . . . . . . . . . . . . . 
 . . . . . . . . . . . . . . . . . . . .-. . . . .-. . . . .-. . .-. . . . .-. . . . .-. . . . . . . . . . . . . . . . . . . . 
 . . . . . . . . . . . . . . . . . . . .-. . . . .-. . . . .-. . .-. . . . .-. . . . .-. . . . . . . . . . . . . . . . . . . . 
 . . . . . . . . . . . . . . . . . . . .-. . . . .-. . . . .-. . .-. . . . .-. . . . .-. . . . . . . . . . . . . . . . . . . . 
 . . . . . . . . . . . . . . . . . . . .-. . . . .-. . . . .-. . .-. . . . .-. . . . .-. . . . . . . . . . . . . . . . . . . . 
 . . . . . . . . . . . . . . . . . . . .-. . . . .-. . . . .-. . .-. . . . .-. . . . .-. . . . . . . . . . . . . . . . . . . . 
 . . . . . . . . . . . . . . . . . . . .-. . . . .-. . . . .-. . .-. . . . .-. . . . .-. . . . . . . . . . . . . . . . . . . . 
 . . . . . . . . . . . . . . . . . . . .-. . . . .-. . . . .-. . .-. . . . .-. . . . .-. . . . . . . . . . . . . . . . . . . . 
 . . . . . . . . . . . . . . . . . . . .-. . . . .-. . . . .-. . .-. . . . .-. . . . .-. . . . . . . . . . . . . . . . . . . . 
 . . . . . . . . . . . . . . . . . . . .-. . . . .-. . . . .-. . .-. . . . .-. . . . .-. . . . . . . . . . . . . . . . . . . . 
 . . . . . . . . . . . . . . . . . . . .-. . . . .-. . . . .-. . .-. . . . .-. . . . .-. . . . . . . . . . . . . . . . . . . . 
 . . . . . . . . . . . . . . . . . . . .-. . . . .-.-.-.-.b.b.b.b.b.b.-.-.-.-. . . . .-. . . . . . . . . . . . . . . . . . . . 
 . . . . . . . . . . . . . . . . . . . .-. . . . . . . . .b.-.-.-.-.b. . . . . . . . .-. . . . . . . . . . . . . . . . . . . . 
 . . . . . . . . . . . . . . . . . . . .-.-.-.-.-.-.-.-.-.b.-.-.-.-.b.-.-.-.-.-.-.-.-.-. . . . . . . . . . . . . . . . . . . . 
 . . . . . . . . . . . . . . . . . . . . . . . . . . . . .-.-.-.-.-.-. . . . . . . . . . . . . . . . . . . . . . . . . . . . . 
 . . . . . . . . . . . . . . . . . . . . . . . . . . . . .-.-.-.-.-.-. . . . . . . . . . . . . . . . . . . . . . . . . . . . . 
 . . . . . . . . . . . . . . . . . . . . . . . . . . . . .b.b.b.b.b.b. . . . . . . . . . . . . . . . . . . . . . . . . . . . . 
 . . . . . . . . . . . . . . . . . . . . . . . . . . . . .w.b.w.w.b.w. . . . . . . . . . . . . . . . . . . . . . . . . . . . . 
 . . . . . . . . . . . . . . . . . . . . . . . . . . . . .w.b.w.w.b.w. . . . . . . . . . . . . . . . . . . . . . . . . . . . . 
 . . . . . . . . . . . . . . . . . . . . . . . . . . . . .w.b.w.w.b.w. . . . . . . . . . . . . . . . . . . . . . . . . . . . . 
 . . . . . . . . . . . . . . . . . . . . . .b.b.b.b. . . .w.b.w.w.b.w. . . .b.b.b.b. . . . . . . . . . . . . . . . . . . . . . 
 . . . . . . . . . . . . . . . . . . . . . .b.w.w.b. . . .w.b.w.w.b.w. . . .b.w.w.b. . . . . . . . . . . . . . . . . . . . . . 
 . . . . . . . . . . . . . . . . . . . . .w.b.w.w.b.w. . .w.b.w.w.b.w. . .w.b.w.w.b.w. . . . . . . . . . . . . . . . . . . . . 
 . . . . . . . . . . . . . . .#.#. . . . .w.b.w.w.b.w. . .w.b.w.w.b.w. . .w.b.w.w.b.w. . . . .#.#. . . . . . . . . . . . . . . 
 . . . . . . . . . . . . . .b.b.b.b. . . .w.b.w.w.b.w. . .w.b.w.w.b.w. . .w.b.w.w.b.w. . . .b.b.b.b. . . . . . . . . . . . . . 
 . . . . . . . . . . . . . .b.w.w.b. . . .w.b.w.w.b.w. . .w.b.w.w.b.w. . .w.b.w.w.b.w. . . .b.w.w.b. . . . . . . . . . . . . . 
 . . . . . . . . . . . . . .b.w.w.b. . . .w.b.w.w.b.w. . .w.b.w.w.b.w. . .w.b.w.w.b.w. . . .b.w.w.b. . . . . . . . . . . . . . 
 . . . . . .#.#.#.#. . . . .b.w.w.b. . . .w.b.w.w.b.w. . .w.b.w.w.b.w. . .w.b.w.w.b.w. . . .b.w.w.b. . . . .#.#.#.#. . . . . . 
 . . . . .w.b.b.b.b.w. . .w.b.w.w.b.w. . .w.b.w.w.b.w. . .w.b.w.w.b.w. . .w.b.w.w.b.w. . .w.b.w.w.b.w. . .w.b.b.b.b.w. . . . . 
 . . . . .w.b.w.w.b.w. . .w.b.w.w.b.w. . .w.b.w.w.b.w. . .w.b.w.w.b.w. . .w.b.w.w.b.w. . .w.b.w.w.b.w. . .w.b.w.w.b.w. . . . . 
 . . . . .w.b.w.w.b.w. . .w.b.w.w.b.w. . .w.b.w.w.b.w. . .w.b.w.w.b.w. . .w.b.w.w.b.w. . .w.b.w.w.b.w. . .w.b.w.w.b.w. . . . . 
 . . . . .w.b.w.w.b.w. . .w.b.w.w.b.w. . .w.b.w.w.b.w. . .w.b.w.w.b.w. . .w.b.w.w.b.w. . .w.b.w.w.b.w. . .w.b.w.w.b.w. . . . . 
 . . . . .w.b.w.w.b.w. . .w.b.w.w.b.w. . .w.b.w.w.b.w. . .w.b.w.w.b.w. . .w.b.w.w.b.w. . .w.b.w.w.b.w. . .w.b.w.w.b.w. . . . . 
 . . . . .w.b.w.w.b.w. . .w.b.w.w.b.w. . .w.b.w.w.b.w. . .w.b.w.w.b.w. . .w.b.w.w.b.w. . .w.b.w.w.b.w. . .w.b.w.w.b.w. . . . . 